1111111111111
100C0000C00C1
10010NE001001
10000N0001C01
1000111110011
1P001100C00N1
1111111111111