1111111111111
10000000C0001
10010N0001001
1000000001001
1000011111001
1P0011E0000N1
1111111111111