1111111111111
100C0000C11C1
10000NE001001
10000N0001C01
10P0111110011
1000N000000N1
100000N0N0001
1111111111111