1111111111111
100C0000C0001
10010NE001001
10000N0001001
1000011111001
1P001100C00N1
1111111111111