1111111111111111
1000010100010001
100000C1000C0001
1000000010000001
100000000E10C001
1P00000001010001
1000000000N00001
1111111111111111