1111111111111
100C0000C10C1
10000NE001001
10000N0001C01
100P111110011
100000N0000N1
100NN000N0001
1111111111111